Tutorial Level
7 11
XXXXXXX
XXXXXXX
XXXXXXX
X..X.$X
X.*.$.X
X&XX.^X
X.B!.XX
XSXX.XX
XXXXXXX
XXXXXXX
XXXXXXX
6
6