Level 4
7 11
XXXXXXX
XXXXXXX
XXXXXXX
XX!..*X
XS.&$.X
XX.XX&X
XX.X..X
XB.$.^X
XXXXXXX
XXXXXXX
XXXXXXX
5
5